(G)I-DLE - Lucid

Ahn Yeeun - Changgwi

ARTMS - Birth

ATEEZ - The Black Cat Nero

Baekhyun - Psycho

BeWhy - Gottasadae

Billlie - everybody's got a $ECRET

CRAXY - Poison Rose

DKZ - BlockBuster

DPR IAN - Don't Go Insane

Dreamcatcher - Chase Me

DreamNote - Ghost

Everglow - Zombie

EXO - Jekyll

f(x) - Dracula

Gain - Paradise Lost

Girls' Generation - Villain

GWSN - I Can't Breathe

Jun - Psycho

Kang Daniel - Paranoia

Lovelyz - Obliviate

Max Changmin - Devil

Moonbyul - Eclipse

Narsha - Bbi Ri Bba Bba

NCT 127 - Favorite (Vampire)

ONF - Goosebumps

Pentagon - Dr. BeBe

PinkFantasy - Tales of the Unusual

Pixy - Bewitched (English version)

Purple Kiss - Ponzona

Seori - Fairy Tale

Seulgi - Dead Man Runnin'

SHINee - Orgel

Stray Kids - Venom

Sunmi (ft. Lena) - Full Moon

Sunny Hill - Midnight Circus

Taemin - Shadow

The Boyz - Drink It

TRI.BE - Witch

TXT - Can't You See Me?

VERIVERY - Get Away

Victon - Nightmare

VIXX - Hyde

WayV - Phantom

Xdinary Heroes - Man in the box

*(G)I-DLE - Put It Straight (Nightmare Version)

*Golden Child - Wannabe

*ONF - Everybody (RTK Version)

*Queendom Puzzle - Web

*VERIVERY - Photo (RTK Version)